8 8
2 2
- - - M - - $ +
- - - - - - + $
- - - - - + ! M
- - - - - - + M
M - - - - - - -
- - - - - - - @
- - - - M - - -
M - - - @ - - 